HDF	IDF
Agave.inulin	SDF
PDX	SDF
SCF	SDF
RW	IDF
RS4	IDF
B.GOS	SDF
FOS	SDF
WG	IDF
Î².glucan	SDF
ITFs	SDF
GOS	SDF
RS	IDF
DF	IDF
Avocado	IDF
RMD	IDF
AXOS	IDF
MSPrebiotic	IDF
RS2	IDF
RG	IDF
Walnut	IDF
RPS	IDF
PCS	IDF
PPB	IDF
XOS	IDF
KGM	SDF
Inulin	SDF
LKFibre	IDF
JA	SDF
CH	SDF
PHGG	SDF
VLCI	SDF
