HDF	IDF
Agave inulin	SDF
PDX	SDF
SCF	SDF
RW	Mixed
RS4	SDF
B-GOS	SDF
FOS	SDF
WG	Mixed
Î²-glucan	SDF
ITFs	SDF
GOS	SDF
RS	IDF
DF	Mixed
Avocado	Mixed
RMD	SDF
AXOS	SDF
MSPrebiotic	IDF
RS2	IDF
RG	Mixed
Walnut	Mixed
RPS	IDF
PCS	Mixed
PPB	Mixed
XOS	SDF
KGM	SDF
Inulin	SDF
LKFibre	Mixed
JA	SDF
CH	SDF
PHGG	SDF
VLCI	SDF
